TEX = Texas Rangers
DET = Detroit Tigers
SEA = Seattle Mariners
ANA = Los Angeles Angels of Anaheim
CLE = Cleveland Indians
MIN = Minnesota Twins
HOU = Houston Astros
CHA = Chicago White Sox
KCA = Kansas City Royals
MIA = Miami Marlins
ATL = Atlanta Braves
BAL = Baltimore Orioles
OAK = Oakland Athletics
TBA = Tampa Bay Rays
TOR = Toronto Blue Jays
WAS = Washington Nationals
NYN = New York Mets
MIL = Milwaukee Brewers
COL = Colorado Rockies
PHI = Philadelphia Phillies
SLN = St. Louis Cardinals
SFN = San Francisco Giants
BOS = Boston Red Sox
ARI = Arizona Diamondbacks
CIN = Cincinnati Reds
SDN = San Diego Padres
NYA = New York Yankees
PIT = Pittsburgh Pirates
LAN = Los Angeles Dodgers
CHN = Chicago Cubs